S,P,P,P,P,P,P,P,P,P
P,E,E,P,E,E,P,E,E,P
P,E,E,P,E,E,P,E,E,P
P,E,E,P,E,E,P,E,E,P
P,E,E,P,E,E,P,E,E,P
P,E,E,P,E,E,P,E,E,P
P,E,E,P,E,E,P,E,E,P
P,E,E,P,E,E,P,E,E,P
P,E,E,P,E,E,P,E,E,P
P,E,E,P,E,E,P,E,E,P
P,P,P,P,P,P,P,P,P,P
